NO ./textures/bluestone.xpm
SO ./textures/colorstone.xpm
WE ./textures/greystone.xpm
EA ./textures/redbrick.xpm

F 171,159,0
C 0,115,191

111111111111111111111111111
100000000000000000000000001
101111111111011111111111101
101         1           101
101        101          101
1001      10001         101
10001    1000001        101
100001  100000001       101
100000110000000001111111101
1000000W0000000000000000001
10000011000000000111111111
100001  100000001
10001    1000001
1001      10001     1111
10111111111101      1001
10000000000001      1001
 111111111111       1111